NO ./assets/textures/validTextures/north.xpm
SO ./assets/textures/validTextures/south.xpm
WE ./assets/textures/validTextures/west.xpm
EA ./assets/textures/validTextures/east.xpm

F 0,120,0
C 0,0,120

111111111              11111111111111
1011000011111111111111110000000000001
1001000000000000000000000000000000001
1001100000000000000000000000000000001
1000000000010000000000000000000000001
1111100000010000000W00000000000000001
1011000000000000000000000000000000001
1011000000000000000000000000000000001
1011000000000000000000000000000000001
1111111111111111111111111111111111111
