NO ./assets/textures/backroom.xpm
SO ./assets/textures/backroom.xpm
WE ./assets/textures/backroom.xpm
EA ./assets/textures/backroom.xpm

F 200,200,200
C 80,80,80

	   	1111111111111111111111111
		1000000000110000000000001
		1011000001110000000000001
		1001000000000000000000001
111111111011000001110000000000001
1000000000110000011101
111100000000000000011100000011111
111100000000000001000010010001
11000000000000000000000010001
10000000000000000000000010011
10000000000000001101010000001
11000001110101011111011110N01
11110111 1110101 101111010001
11111111 1111111 111111111111
