NO ./assets/textures/north.xpm
SO ./assets/textures/south.xpm
WE ./assets/textures/west.xpm
EA ./assets/textures/east.xpm

F 100,100,100
C 200,200,255

1111111111
1000000001
1011111101
1000000101
1010010101
1000N00001
1111111111
