		1111111111111111111111111
		1000000000110000000000001
		1011000001110000000000001
		1001000000000000000000001
111111111011000001110000000000001
100000000011000001110111111111111
11110111111111011100000010001
11110111111111011101010010001
11000000110101011100000010001 NO ./assets/textures/north.xpm
10000000000000001100000010001 SO ./assets/textures/south.xpm
10000000000000001101010010001 WE ./assets/textures/west.xpm
11000001110101011111011110N01 EA ./assets/textures/east.xpm
11110111 1110101 101111010001 F 220,200,0
11111111 1111111 111111111111 C 225,30,0
