NO ./assets/textures/backroom.xpm
SO ./assets/textures/backroom.xpm
WE ./assets/textures/backroom.xpm
EA ./assets/textures/backroom.xpm

F 185,165,105
C 215,195,135

        1111111111111111111111111111111111111111
        1000000000000000000000000000000000000001
        1011111011111101111110111111011111101101
        1010001000001000000010000010000001000101
        1010101111101011111010111010111101110101
        1010100000101000001010001010100001000101
        1011111110101110101011101011101111011101
        1000000010001000101000001000001000000101
111111111011101011101011101111101110101111011111111111
100000000000001000001000001000001000001000000000000001
101111111111101111101111101011101111101111111111111101
101000000000100000100000101010000000100000000000000101
101011111110111110111110101011111110111111111111110101
101010000010000010000010101010000010000000000000010101
101010111011111011111010101011101011111111111111010101
101010101000001000001010101000101000000000000001010101
101010101111101111101010111110101111111111111101010101
101010100000100000101010000010100000000000000101010101
101011111110111110101011111010111111111111110101010101
100000000010000010101000001010000000000000010101010101
111111111011111010101110101011111111111111010101010101
        1000001010100010101000000000000010101010101
        1111101010101110101111111111111010101010101
        1000101010100000100000000000001010101010101
        1110101010111111111111111111101010101010101
        1000101010000000000000000000101010101010101
        1110101011111111111111111110101010101010101
        1000100000000000000000000010101000001000101
        1110111111111111111111111010101111101110101
        1000000000000000000000001010100000100000101
        1011111111111111011111101010111110111110101
        1010000000000000000000101010000010000010101
        1010111111111111111110101011111010111010101
        10100000000000000000N0101000001010001010101
        1011111111111111111111101111101011101010101
        1000000000000000000000000000001000001000001
        1111111111111111111111111111111111111111111
