NO ./assets/textures/backroom.xpm
SO ./assets/textures/backroom.xpm
WE ./assets/textures/backroom.xpm
EA ./assets/textures/backroom.xpm

F 185,165,105
C 215,195,135

11111111111111111111111111111111111111111111111111
10000010000100101001010000100000010000001010000101
10001000010010000100010010101010010101010000010001
10110100001000110010100100001001010101100010010101
11000011100011001000101001001000100100001010001001
10001000010100001001001000000110010011100010100001
10101001011001100101001011110001000100001010001101
10101010000100010000100100001010000010100100010001
10100100100011001110010001001001001010001001001001
10010000101000100000101110101000010010001001101001
10011100110000011001000000101010000011010000001001
10100001000100000100001011001100110000010100000101
10101000101011000010101000100010000101010101110101
10101010000000110010001100111010111001010010000101
10001010010010001001000010000011000000101010111001
10001010101100101001010011010000010011000010000001
11001001000000101000100000100100100100011100000111
10010001001001000100101000110010001001000001001001
100100010100N0110100100001001000101010101100001101
10000101001001000110110010001111001010000010000001
10001001001001010000001000100000001001110010010001
10001000110001001001101100111001101010000001100101
11001000001011100100000001000110001000101100010001
10000101101001010110000001010001000110100001001001
10100100000100000001001110001001001000110010010001
10010010010101100101010000010001010001001010010101
10011000010010001001001001100101100100000010010011
10000010011000010001001010000100001011111100100001
10101010100100100010010011010110100000000010000101
10100100101001010101000100010001000100111101010101
10010000100010010100011010101110001001000001001001
11001111001100010101100000000000010010001001100011
10010000010001010100001000010000101001000100011001
10100100101000100100001011001001001100100100100011
10100010000001001010101000100100000010100010001001
10010010100101010001000110001001001000011001000001
11001010010110011100101000000100110001000010011001
10101011010001000010100100110101000000100001100101
10001000011100110010001001000010010101000100000001
10010100000010001010100010100100010010001011000001
10100100100100101010010010110100101001010000100111
10100001001001001001000100000101000101000010001001
10010100001010010010110001101001001001101001000001
10010111000010100100001000010010010010001010011001
10010000111100101000100010010010000100010010100101
11011000000000100010111100100010001001100010000101
10000000110110010010000000101000000100000010010101
10110111001001100010011100110101001000000101010001
10000000000000000010000000000001000100000000010001
11111111111111111111111111111111111111111111111111
