NO ./assets/textures/pedra.xpm
SO ./assets/textures/cruz.xpm
WE ./assets/textures/h.xpm
EA ./assets/textures/n.xpm

F 138,124,102
C 58,45,25

11111111111111111111111111111
10000000000000100000000000001
10000000000000100000000000001
10000111110000100001111100001
10000100010000100001000100001
10000100010000000001000100001
10000100010000000001000100001
10000100011111111111000100001
10000000000000000000000000001
10000000000000000000000000001
11111111000000000000111111111
10000001000000000001000000001
10000001000111101111000000001
10000001000100000001000000001
10000001000100000001000000001
10N00000000010000000000000001
11111111111111111111111111111
