NO ./assets/textures/madeira.xpm
SO ./assets/textures/aguia.xpm
WE ./assets/textures/verde.xpm
EA ./assets/textures/caveira.xpm

F 179,166,147
C 29,23,12

1111111111111111111111111111111111111111111
1000000000000000000000000111110000000000001
1000000011111111100000000110010000110000001
1000000010000000100000000110010000110000001
1000000010000000100000000110010000110000001
1000000010000000111111111110011111111110001
1000000010000000000000000000000000000010001
1000000010000000000000000000000000000010001
1001111111111110001111111111111111000010001
1001000000000010001000000000000001000010001
1001000000000010001000000000000001000010001
1001000000000010001000000000000001000010001
1001000111111110001111111111111111001110001
1001000100000000000000000000000000000000001
1001000100000000000000000000000000000000001
1001000111111000111111111111111111111110001
1001000000001000100000000000000000000010001
1001000000001000100000000000000000000010001
1001111111101111100001111111000111111110001
1000000000100000000001000001000100000000001
1000000000100000000001000001000100000000001
1000000000100000000001000001000100000000001
1000000000111111111111000001111100000000001
10000000000000000000000000000000000000000N1
1111111111111111111111111111111111111111111
