NO ./assets/textures/north.xpm
SO ./assets/textures/south.xpm
WE ./assets/textures/west.xpm
EA ./assets/textures/east.xpm

F 200,200,200
C 80,80,80

111111
10S001
100001
100001
100001
100001
100001
100001
100001
100001
111111
