NO ./assets/textures/malucos.xpm
SO ./assets/textures/malucos.xpm
WE ./assets/textures/malucos.xpm
EA ./assets/textures/malucos.xpm

F 38,105,255
C 0,160,0

1111111111111111111111111
1000000000000000000000001
1000000000000000000000001
1000000000000000000000001
1000000000000000000000001
1000000100000001000000001
1000000100000001000000001
10000001000N0001000000001
1111111111111111111111111