NO ./assets/textures/madeira.xpm
SO ./assets/textures/aguia.xpm
WE ./assets/textures/verde.xpm
EA ./assets/textures/caveira.xpm

F 112,101,86
C 47,41,33

1111111111111111111111111111111111111111111111111111111111
1000000011111111111000000000000000000011111110000000000001
1000000010000000001000000011111111000010000010001111111001
1000000010000000001000000010000001000010000010001000001001
1000000010001110001111000010000001000010000010001000001001
1000000010001000000001000010111101111011111010001111101001
1000000010001000000001000010000000000000000010000000101001
1001111110001001111101111110001111111111100011111110101001
1001000000001001000000000000001000000000100000000010101001
1001000000001001000111111111001000111111101111111010101001
1001000111111001000100000001001000100000001000000010101001
1001000100000000000100000001001000100000001000000010101001
1001000100001111111100000001111000111111101111111110101001
1001000100001000000000000000000000000000100000000000101001
1111110100001000000001111111111111100000101111111111101001
1000000100001111110001000000000000100000101000000000001001
1000000100001000010001000000000000100000101001111111101001
1000000100001000010001111111111111100000101001000000101001
1111111100001000010000000000000000000000101001000000101001
1000000000001000010000000000000000001111101001000000101001
1000000000001111110001111111111111101000101001000000101001
1000000000000000000001000000000000101000101001000000101001
1111111111111111111001000000000000101000101111000000101001
1000000000000000001001111111111111101000000000000000101001
1000000000000000001000000000000000001000000000000000101001
1000000000000000001111111111111000001111111111001111101001
1000000000000000001000000000001000000000000001001000001001
1111111111111110001000000000001000000000000001001000001001
1000000000000010001111111111001111111111111101001111101001
1000000000000010001000000001000000000000000101001000101001
1000000000000010001000000001000000000000000101001000101001
1111111111111110001000000001111111111111100101001111101001
1000000000000000001000000000000000000000100001000000001001
1000000000000000001111111111111111111000100001111111111001
1000000000000000000000000000000000001000100000000000000001
1000000000000000000000000000000000001000100000000000000001
1000111111111111111111111111111111101000111111111111111111
1000100000000000000000000000000000101000000000000000000001
1000100000000000000000000000000000101000000000000000000001
1000111111110001111111111111111111101111111111111110000001
1000000000010001000000000000000000000000000000000010000001
1000000000010001000000000000000000000000000000000010000001
10000000000100011111111111111111111111111111111111100000N1
1111111111111111111111111111111111111111111111111111111111

