NO ./assets/textures/madeira.xpm
SO ./assets/textures/aguia.xpm
WE ./assets/textures/verde.xpm
EA ./assets/textures/caveira.xpm

F 112,101,86
C 47,41,33

1111111111111111111111111111111111111111111111111111111111
1000000000000000000000000000011110000000000000000000000001
1001111111111111111111110000010010000111111111100001111001
1001000000000000000010010000010010000100000000100001001001
1001000000000000000010011111110011111100000000100001001001
1001000001111111111110000000000000000011111111100001001001
1001000001000000000000000000000000000000000000000001001001
1001000001000000000000000000000000000000000000000001001001
1001000001111111111111111111111111111111111111111101001001
1001000001000000000000000000000000000000000000000101001001
1001111101000111111111111111111111111111111111000101001001
1000000101000100000000000000000000000000000010000101001001
1111100101000100000000000000000000000000000010000101001001
1000000101000101111111111111111111111111111010000101001001
1000000101000101000000000000000000000000000010000101001001
1000000101000101000000000000000000000000000010000101001001
1000000101000101111111111111111111111111111010000101001001
1000000101000100000000000000000000000000000010000101001001
1000000101000111111111111111111111111111111110000101001001
1000000101000000000000000000000000000000000000000101001001
1111100101111111111111111111111111111111111111111101001001
1000000100000000000000000000000000000000000000000001001001
1000000100000000000000000000000000000000000000000001001001
1000000101111111111111111111111111111111111111111111001001
1000000101000000000000000000000000000000000000000000001001
1111111101000000000000000000000000000000000000000000001001
1000000001000111111111111111111111111111111111111111101001
1000000001000100000000000000000000000000000000000000101001
1000000001000100000000000000000000000000000000000000101001
1000000001111100000000000000000000000000000000000000101001
1000000000000000000000000000000000000000000000000000100001
10000000000000000000000000000000000000000000000000001000N1
1111111111111111111111111111111111111111111111111111111111
